1111111111111
1000110011001
1000110011001
1000110011001
1000000000011
1111111111111