11111111111
10001000001
10001000001
10001000001
10000000011
11111111111